6
-.w.-.-.-.-
-.p.p.w.w.-
w.-.p.a.-.-
w.-.-.-.-.-
-.-.-.p.p.-
-.-.-.-.-.-