7
-.-.-.-.-.-.-.-.-.-
g.-.-.-.-.w.g.-.-.-
-.p.g.-.-.-.-.-.-.p
-.-.-.p.-.-.-.-.-.-
-.-.-.-.-.-.-.-.a.-
-.-.-.-.p.-.-.-.-.p
-.-.g.-.-.-.-.-.-.-