6
-.w.-.-.-.-
-.p.p.w.w.-
w.-.p.-.-.-
w.-.-.-.-.-
-.-.-.p.p.-
-.-.-.-.-.a